NO textures/simonkraft/bookshelf.xpm
SO textures/simonkraft/bookshelf_01.xpm
WE textures/simonkraft/bookshelf_02.xpm
EA textures/simonkraft/bookshelf_03.xpm

F 220,100,00000
C 225,30,0


        1111111111111111111111111
        1000000000110000000000001
        1011000001110000000000001
        1001000000000000000000001                                     1            
111111111011000001110000000000001
100000000011000001110111111111111
11110111111111111100000010001
11110111111111  11101010010001
11000000110101   11100000010001
100000000000001111000000100011
10000000000000001101010010001
11000001110101011111011110N0111
11110111 1110101 101111010001
11111111 1111111 111111111111